11111111111
1PC000000E1
10000C10001
10000C10001
10000010001
11111111111