11111111111111
10001P11110001
100011100000C1
1000000000E001
100000C0000001
11111111111111